0000000000000000000000000000000000000000000000
0000000000000000000000000000000000000000000000
0000000000000000000000000000000000000000000000
0000010010010010010010010010010010010010010000
0000010010010010010010010010010010010010010000
0000010010010010010010010010010010010010010000
0000010010010010010010010010010010010010010000
0000010010010010010010010010010010010010010000
1111111111111111111111111111111111111111111111
1111111111111111111111111111111111111111111111
0000010010010010010010010010010010010010010000
0000010010010010010010010010010010010010010000
0000010010010010010010010010010010010010010000
0000010010010010010010010010010010010010010000
0000010010010010010010010010010010010010010000
0000000000000000000000000000000000000000000000
0000000000000000000000000000000000000000000000
0000000000000000000000000000000000000000000000