1111111111111111111111111111111111111111111111
1000000000000000000000000000000000000000000001
1000000000000000000000000000000000000000000001
1000003303303303303303303303303303303303300001
1000003303303303303303303303303303303303300001
1000003303303303303303303303303303303303300001
1000003303303303303303303303303303303303300001
1000003303303303303303303303303303303303300001
0000000000000000000000000000000000000000000001
0000000000000000000000000000000000000000000001
1000003303303303303303303303303303303303300001
1000003303303303303303303303303303303303300001
1000003303303303303303303303303303303303300001
1000003303303303303303303303303303303303300001
1000003303303303303303303303303303303303300001
1000000000000000000000000000000000000000000001
1000000000000000000000000000000000000000000001
1111111111111111111111111111111111111111111111