1111111111111111111111111111111111111111111111
1000000000000000000000000000000000000000000001
1000001000000000000000000000000000000000000001
1000001100000000001000000100000000000000000001
1000000100000000001000000110000000000100000001
1000000100000001111111000010000000000100000001
1000100100000000000000000010000000000100000001
1000100000000001000000000010000000111100000001
0000000000000001000000000000000000100000000000
0000000000000000000000000000000000000000000000
1000000000000000000000000000000000000000000001
1000000100000000000000000000000000000000110001
1000001100000000000000000111111000000000110001
1000001100001110000000000100000000100000110001
1000000100001000000000000100011111110000110001
1000000100000000000000000000000000000000110001
1000000000000000000000000000000000000000000001
1111111111111111111111001111111111111111111111