1111111111111111111111111111111111111111111111
1000000000000000000000000000000000000000000001
1000000000000000000000000000000000000000000001
1000000000000000000000000000000000000000000001
1001111100111110011110001111000111110010001001
1001000000100010010001001000100100000011001001
1001001100111110011110001000100111000010101001
1001000100100010010001001000100100000010011001
0001111100100010010001001111000111110010001001
0000000000000000000000000000000000000000000001
1000000000000000000000000000000000000000000001
1001111111111111111111111111111111111111111001
1000000000000000000000000000000000000000000001
1000000000001111111111111111111111000000000001
1000000000000000000000000000000000000000000001
1000000000000000001111111111000000000000000001
1000000000000000000000000000000000000000000001
1111111111111111111111111111111111111111111111