1111111111111111
1000000000000001
0000000000000001
0000000000000001
1000000000000001
1111111111111111