1111111111111111111111111111111111111111111111
1000000000000000000000000000000000000000000001
1000000000003000000000000000000003000000000001
1000000000003000000000110000000003000000000001
1000000000003000000001111000000003000000000001
1000000000003000000001101000000003000000000001
1002000200003005000001011000060003000020002001
1000000000000000000000000000000000000000000001
0000000000000000000000000000000000000000000000
0000000000000000000000000000000000000000000000
1033333333004000400040000400040004003333333301
1030000000000040004000000004000400000000000301
1030333333004000400040000400040004003333330301
1030300003000040004000000004000400003000030301
1030000003004000400040000400040004003000000301
1033333333000000000000000000000400003333333301
1000000000000000000000000000000000000000000001
1111111111111111111111111111111111111111111111