1111111111111111111111111111111111111111111111
1000000000000000000000000000000000000000000001
1000000000000011111111111111111000000000000001
1000000000001100000000000000000110000000000001
1000000000001111111111111111111110000000000001
1000000000001111111111111111111110000000000001
1000000000001111111111110000001110000000000001
1000000000001111111111110000001110000000000001
0000000000001110000011110000001110000000000000
0000000000001110000011110000001110000000000000
1000000000001110000011111111111110000000000001
1000000000001110000011111111111110000000000001
1000000000001110000011111111111110000000000001
1000000000000000000000000000000000000000000001
1000000000000000000000000000000000000000000001
1000000000000000000000000000000000000000000001
1000000000000000000000000000000000000000000001
1111111111111111111111111111111111111111111111