0000000000000000000000000000000000000000000000
0000000000000000000HIJKLMN00000000000000000000
0000000000000000000ABCDEFG00000000000000000000
0000000000000000000:;<=>?@00000000000000000000
0067806780000000000000000000000000000678067800
0034503450000000000000000000090000000345034500
0010201020000000000000000000000000000102010200
0000000000000000000000000000000000000000000000
0000000000000000000000000000000000000000000000
0000000000000000000000000000000000000000000000
0000000000000000000000000000000000000000000000
0000000000000000000000000000000000000000000000
0000000000000000000000000000000000000000000000
0000000000000000000000000000000000000000000000
0000000000000000000000000000000000000000000000
0000000000000000000000000000000000000000000000
0000000000000000000000000000000000000000000000
0000000000000000000000000000000000000000000000