0000000000000000000000110000000000000000000000
0000000000000000000000110000000000000000000000
0000000000000000000000110000000000000000000000
0000000000000000000000110000000000000000000000
0000000000000000000000110000000000000000000000
0001111111111111111111111111111111111111111000
0001111111111111111111111111111111111111111000
0000000000000000000000110000000000000000000000
0000000000000000000000110000000000000000000000
0000000000000000000000110000000000000000000000
0000000000000000000000110000000000000000000000
0000000000000000000000110000000000000000000000
0001111111111111111111111111111111111111111000
0001111111111111111111111111111111111111111000
0000000000000000000000110000000000000000000000
0000000000000000000000000000000000000000000000
0000000000000000000000000000000000000000000000
0000000000000000000000000000000000000000000000