1111111111111111111111001111111111111111111111
1000000000000000000000000000000000000000000001
1000000000000000000000000000000000000000000001
100000000EFGHIJK00000100100000EFGHIJK000000001
100000000>?@ABCD00000000000000>?@ABCD000000001
100000000789:;<=00000000000000789:;<=000000001
1000001000300030001001001001000300030001000001
1000000000000000000000000000000000000000000001
1000000000000000000000000000000000000000000001
1000001000000000001001001001000000000001000001
100000000EFGHIJK00000000000000EFGHIJK000000001
100000000>?@ABCD00000000000000>?@ABCD000000001
100000000789:;<=00000000000000789:;<=000000001
1000001000300030001001001001000300030001000001
1000000000000000000000000000000000000000000001
1000000000000000000000000000000000000000000001
1000000000000000000001001000000000000000000001
1111111111111111111111111111111111111111111111