1111111111111111111111001111111111111111111111
1000000000000000000000000000000000000000000001
1000000000000000000000000000000000000000000001
1000001111111111111111111111111111111111000001
1000000000000000000000000000000000000000000001
1000001111111111111111001111111111111111000001
1000000000000000000001001000000000000000000001
1000000000000000000001001000000000000000000001
1000000000000000000001001000000000000000000001
1000000000000000000001001000000000000000000001
1000000000000000000001001000000000000000000001
1000000000000000000001001000000000000000000001
1000000000000000000001001000000000000000000001
1000000000000000000001001000000000000000000001
1000000000000000000000000000000000000000000001
1000000000000000000000000000000000000000000001
1000000000000000000000000000000000000000000001
1111111111111111111111111111111111111111111111