0000000000000000000000000000000000000000000000
000000000HIJKLMN00000000000000HIJKLMN000000000
000678000:;<=>?@06780000006780:;<=>?@000678000
0003450000000000034500000034500000000000345000
0001020000000000010200000010200000000000102000
0000000000000000000000000000000000000000000000
0000000000000000000000000000000000000000000000
0000000000000000000000000000000000000000000000
000000000HIJKLMN00000000000000HIJKLMN000000000
000678000:;<=>?@06780000006780:;<=>?@000678000
0003450000000000034500000034500000000000345000
0001020000000000010200000010200000000000102000
0000000000000000000000000000000000000000000000
0000000000000000000000000000000000000000000000
0000000000000000000000000000000000000000000000
0000000000000000000000000000000000000000000000
0000000000000000000000000000000000000000000000
0000000000000000000000000000000000000000000000