0000000000000000000000000000000000000000000000
000000000HIJKLMN00000000000000HIJKLMN000000000
000000000:;<=>?@00000000000000:;<=>?@000000000
0000000000000000000000000000000000000000000000
0000000000000000000000000000000000000000000000
0000000000000000000000000000000000000000000000
0000000000000000000000000000000000000000000000
0000000000000000000000000000000000000000000000
000000000HIJKLMN00000000000000HIJKLMN000000000
000000000:;<=>?@00000000000000:;<=>?@000000000
0000000000000000000000000000000000000000000000
0000000000000000000000000000000000000000000000
0000000000000000000000000000000000000000000000
0000000000000000000000000000000000000000000000
0000000000000000000000000000000000000000000000
0000000000000000000000000000000000000000000000
0000000000000000000000000000000000000000000000
0000000000000000000000000000000000000000000000