0000000000000000000000000000000000000000000000
0000000100000000000000000000000000100000000000
0000000001000000001021000001000001000000000000
0001000001000000100000000010000000000000000000
0000000000100000000001000000000000000002011000
0000010100000001000000000000001200000000000000
0000010001000000001000000000000000000100000000
0000000000001000000000000000000000000000000000
0000101000000000000000111111111111111111111111
0000000000201010000000111111111111111111111111
0000100010000000002000110000000000000000000000
0000200000000000000000110000000000000000000000
0000000010100000000000110020000000100000000000
0000000000000000000000110000000001000001000000
0000100010000000000000110000000001000100000000
0000000000100000000000110000100000000001000000
0000000000000000000000110000100001000001000100
0000000000000000000000110000000000000000000000