0000000000000000000000000000000000000000000000
0000000100000000000000000000000000100000000000
0000000000000000000020000000000000000000000000
0000000000000000000000000000000000000000000000
0000000000000000000000000000000000000000200000
0000000000000000000000000000002000000000000000
0000000001000000000000000000000000000100000000
0000000000000000000000000000000000000000000000
0000000000000000000001111111111111111111111111
0000000000200000000000111111111111111111111111
0000000000000000002000110000000000000000000000
0000200000000000000000110000000000000000000000
0000000000100000000000110020000000100000000000
0000000000000000000000110000000000000000000000
0000000000000000000000110000000000000000000000
0000000000000000000000110000000000000001000000
0000000000000000000000110000000000000000000000
0000000000000000000000110000000000000000000000