1111111111111111111111111111111111111111111111
1000000000000000000000000000000000100000000001
1001111001001111001000001110000001110000000001
1001000000001000001000001001000101010000000001
1001111001001110001000001001000101010100000001
1001000001001000001000001001000101010100000001
1001000001001111001111001110000000000100000001
1000000000000000000000000000000001111000000001
1101000001000001000000000000000001000000000000
1101000001001001000000000000000000000000000000
1000001000001000000000000000000000000000000001
1000001100000000000000000000000000000000110001
1000001100000000000000000111111000000000110001
1000001100001110000000000100000000100000110001
1000000100001000000000000100011111110000110001
1000000100000011111000000000000000000000110001
1000000000000011111000000000000000000000000001
1111111111111111111111001111111111111111111111