1111111111111111111111111111111111111111111111
1003000300000000000000000300000000000000000001
1000000000030000030000000000000030000000000001
1020003000000000000030000300040000000000000001
1000000000002000003000000000000000002000003001
1000003000000040000000000000200000000000000001
1000000000030000003002000000000004000000000001
1003000020000030400000040000000000000030030031
1000000000000000003000000000000000000000000000
1000400000000000000000000000000000000000000000
1000000000000400003000004000000004000030030031
1003000002000000000000000003000000003000000001
1000000000000000000003003000000300000000002001
1000003000000000000000000003000000200030000001
1000000000003000000003003000000000000002000401
1003000003000000000000000020000030040000000001
1000000000000003000003003000000000000000030001
1111111111111111111111001111111111111111111111