0000000000000000000000000000000000000000000000
0678000000000000000000000000000000000000000000
0345000000067800000000000000000000067800000000
0102000000034500000000000006780000034500000000
0000000000010200000000000003450000010200000000
0000000678000000000000000001020000000000000000
0000000345000000000000000000000000000000000000
0000000102000000000000000000000000000000000000
0000000000000000000000000000000000000000000000
0000000067800000000000000000000000000000000000
0000000034500000000000000000000000000000067800
0000000010200000000000000000000006780000034500
0000000000000000000000000000000003450067810200
0000000000000000000000000678000001020034500000
0000000000000000000000000345000000000010200000
0000000000000000000000000102000000000000000000
0000000000000000000000000000000000000000000000
0000000000000000000000000000000000000000000000